121111111
100000001
111010111
111010001
100011101
101110001
101311101
101000001
111111111
