1211111111111111
1000000000000001
1111011111111101
1000011100000001
1011011101101111
1011011100101111
1011111111100001
1000000101111101
1011111101111101
1010001000300101
1110101111110101
1010100000000101
1010111111110101
1011111111110101
1000000000000001
1111111111111111
