#G#######
#       #
### # ###
### #   #
#   ### #
# ###   #
# #S### #
# #     #
#########
