#G##############
#              #
#### ######### #
#    ###       #
# ## ### ## ####
# ## ###  # ####
# ###### ##    #
#      # ##### #
# ###### ##### #
# #   #   S  # #
### # ###### # #
# # #        # #
# # ######## # #
# ########## # #
#              #
################
